9
31 18

06 09 09 09 09 09 09 09 09 09 09 09 09 09 09 09 09 09 09 09 09 09 09 09 09 09 09 09 09 09 08 
13 25 25 25 25 25 25 25 25 25 25 25 25 25 25 25 25 25 25 25 25 25 25 25 25 25 25 25 25 25 13 
13 00 26 00 26 00 26 00 26 00 26 00 26 00 26 00 26 00 26 00 26 00 26 00 26 00 00 00 00 00 13 
13 00 26 00 26 00 26 00 26 00 26 00 26 00 26 00 26 00 26 00 26 00 26 00 26 00 00 00 24 00 13 
13 00 00 00 00 06 08 00 00 00 00 00 00 00 00 00 00 00 00 06 08 00 00 00 00 00 00 00 00 00 13 
13 00 00 00 00 04 05 00 00 00 00 00 00 00 00 00 00 00 00 04 05 00 00 00 00 00 00 00 00 00 13 
13 00 00 00 00 25 25 00 00 00 00 00 00 00 00 00 00 00 00 25 25 00 00 00 00 00 00 00 00 00 13 
13 00 00 00 00 00 00 00 00 00 00 00 00 00 00 00 00 00 00 00 00 00 00 00 00 00 00 00 00 00 13 
13 00 00 00 00 00 00 00 00 00 00 00 00 00 00 00 00 00 00 00 00 00 00 00 00 00 00 00 00 00 13 
13 00 00 00 00 00 00 00 00 00 00 00 00 00 00 00 00 00 00 00 00 00 00 00 00 00 00 00 00 00 13 
13 00 00 00 00 06 08 00 00 00 00 00 00 00 00 00 00 00 00 06 08 00 00 00 00 00 00 00 00 00 13 
13 00 00 00 00 04 05 00 00 00 00 00 00 00 00 00 00 00 00 04 05 00 00 00 00 00 00 00 00 00 13 
13 00 00 00 00 25 25 00 00 00 00 00 00 00 00 00 00 00 00 25 25 00 00 00 00 00 00 00 00 00 13 
13 00 00 00 00 00 00 00 00 00 00 00 00 00 00 00 00 00 00 00 00 00 00 00 00 00 00 00 00 00 13 
13 00 26 00 26 00 26 00 26 00 26 00 26 00 26 00 26 00 26 00 26 00 26 00 26 00 00 00 00 00 13 
13 00 26 00 26 00 26 00 26 00 26 00 26 00 26 00 26 00 26 00 26 00 26 00 26 00 00 00 23 00 13 
04 09 09 09 09 09 09 09 09 09 09 09 09 09 09 09 09 09 09 09 09 09 09 09 09 09 09 09 09 09 05 
20 20 20 20 20 20 20 20 20 20 20 20 20 20 20 20 20 20 20 20 20 20 20 20 20 20 20 20 20 20 20 

11
stairs 28 15 61	32 1 l
stairs 28 03 57 32 1 r

object 3.45 2.45 68 106 assets/Graphics/objects/png_object/object_animation.txt car2_68x106
object 9.45 2.45 68 106 assets/Graphics/objects/png_object/object_animation.txt car5_68x106
object 13.45 2.45 68 106 assets/Graphics/objects/png_object/object_animation.txt car3_68x106
object 23.45 2.45 68 106 assets/Graphics/objects/png_object/object_animation.txt car7_68x106

object 5.45 14.17 68 106 assets/Graphics/objects/png_object/object_animation.txt car4_68x106
object 9.45 14.17 68 106 assets/Graphics/objects/png_object/object_animation.txt car1_68x106
object 15.45 14.17 68 106 assets/Graphics/objects/png_object/object_animation.txt car6_68x106
object 19.45 14.17 68 106 assets/Graphics/objects/png_object/object_animation.txt car8_68x106


object 9 7.8 160 80 assets/Graphics/objects/png_object/object_animation.txt van_160x80
